R 1000 600

NO ./textures/north.xpm
SO ./textures/south.xpm
WE ./textures/west.xpm
EA ./textures/east.xpm

S ./textures/barrel.xpm
F 128, 128, 128
C 56, 210, 223

        1111111111111111111111111
        1000000000110000022000021
        1011000001110000202200001
        100100000000000000W200001
111111111011000001110000000000001
100000000011000001110111111111111
11110111111111011100000010001
11110111111111011101010010001
11000000110101011100000000001
10000000000000001100200010001
10000000000000001101110010001
1100000111010101111101111000111
11110111 1110111 111111010001
11111111 1111111 111111111111
