R 64 64

NO ./textures/colorstone.xpm
SO ./textures/wood.xpm
WE ./textures/redbrick.xpm
EA ./textures/greystone.xpm

S ./textures/barrel.xpm
F 255, 255, 255
C 255, 0, 0

        1111111111111111111111111
        1000000000110000002000021
        1011000001110000000000001
        1001000000000000000000001
111111111011000001110000000000001
100000000011000001110111111111111
11110111111111011100000010001
11110111111111011101010010001
11000000110101011100000000001
10000000000000001100200010001
10000000000000001101W10010001
1100000111010101111101111000111
11110111 1110111 111111010001
11111111 1111111 111111111111