R 1024 748

NO ./textures/redbrick.xpm

SO ./textures/colorstone.xpm

WE ./textures/greystone.xpm

EA ./textures/wood.xpm

S ./textures/star.xpm

F 224,172,105

C 205,249,255

        1111111111111111111111111
        10000000001100000000000W1
        1011000001110002000200001
        1001000000000000000000001
111111111011000001110020200020001
100000000011000001110111111111111
11110111111111011100000010001
11110111111111011101010010001
11000000110101011100000000001
10000000000000001100200010001
10000000000000001101110010001
1100000111010101111101111000111
11110111 1110111 111111010001
11111111 1111111 111111111111
