R 1000 600

NO ./textures/colorstone.xpm
SO ./textures/wood.xpm
WE ./textures/redbrick.xpm
EA ./textures/greystone.xpm

S ./textures/barrel.xpm

F 7, 84, 35
C 70, 165, 240

        1111111111111111111111111
        1000000000110000002000021
        1011000001110000200002001
        100100000000000000W000001
111111111011000001110000000200001
100000000011000001110111111111111
11110111111111011100000010001
11110111111111011101010010001
11000000110101011100000000001
10000200000000001100200010001
10000000000000001101010010001
1100200111010101111101111000111
11110111 1110121 121111010021
11111111 1111111 111111111111